111111111111111111111111
1P0000000100000C00000001
100000000100000000000001
1000C0000100001111100001
100000000100001000100001
111110111100001000100001
1000000000000010C0100001
100000000000001000100001
100011111111111000100101
10001C000000000000000101
1C00100000000000000001E1
111111111111111111111111